0 # # # # # # # # # # # # # #
# + + + + + + + + + + + + + #
# # # # # # # # # # # # # + #
# + + + + + + + + + + + + + #
# + + + + + + # # # # # # # #
# + + + + + + + + + + + + + #
# # # # # # # # + + # # # # #
# + + + + + + + B + + + # # #
# # # # # # # # # # # # # # #